=====================
=---=-----=-=------e=
===-=====-=-===-=====
=-=---=-=-------=---=
=-=-===-=======-=-=-=
=-=---------=---=-=-=
=-=========-=-=-=-=-=
=-----------=-=---=-=
=======-=-===-=-=====
=-=-=-=-=---=-=-=-=-=
=-=-=-=-===-===-=-=-=
=-=-------=-=-------=
=-=======-===-===-===
=-------=---=-=-=-=-=
=-=========-=-=-===-=
=-------------------=
=-=-=-===-===-=====-=
=-=-=-=-=---=-=---=-=
=====-=-=====-===-=-=
=s----=---------=---=
=====================